WWWWWWWWWWWWWWWW
WEVEEEEEEEEEEEEW
WEEEEEEEEEEEEEEW
WEEEETTTTTTTTTEW
WEEEEEEEEETEEEEW
WEEEEEEEEEEEEEEW
WEEEEEEEEEEEEEEW
WEEEEEEEEEEEEEEW
WEEEEEEEEEEEEEEW
WEEEEEEEEEEEEEEW
WEEEEEEEEEEEEEGW
WWWWWWWWWWWWWWWW