WWWWWWWWWWWWWWWWWWWW
WEEEEEEEEEEEEEEEEEEW
WEEETTTTTTTTTTTTEEEW
WEEEEEEEEEEEEEEEEEEW
WEEEEEEEEEEEEEEEEEEW
WVEEEETTTTTTTTEEEEEW
WEEEEEEEEEEEEEEEEEEW
WEEEEEEEEEEEEEEEEEEW
WEEEEEEETTTTEEEEEEEW
WEEEEEEEEEEEEEEEEEEG
WEEEEEEEEEEEEEEEEEEW
WWWWWWWWWWWWWWWWWWWW
