WWWWWWWWWWWWWWWWWWWW
WEEEEEEEEEEEEEEEEEEW
WEEEEEEEEEEEEEEEEEEW
WEEEEETEETEETEEEEEEW
WEEEEETEETEETEEEEEEW
WEEEEETTTTTTTEEEEEEW
WEEEEETTTTTTTEEEEEEW
WEEEEETTTTTTTEEEEEEW
WEEEEEEWWWWWEEEEEEEW
WEEVEEEEEEEEEEEEEEEW
WEEEEEEEEEEEEEEEEEEW
WWWWWWWWWGWWWWWWWWWW
