W W W W W W W W W W W W W W W W W W W W
W E E E E E E E E E E E E E E E E E E W
W E E E E E E E E E E E E E E E E E E W
W E E E E E T E E T E E T E E E E E E W
W E E E E E T E E T E E T E E E E E E W
W E E E E E T T T T T T T E E E E E E W
W E E E E E T T T T T T T E E E E E E W
W E E E E E T T T T T T T E E E E E E W
W E E E E E E W W W W W E E E E E E E W
W E E V E E E E E E E E E E E E E E E W
W E E E E E E E E E E E E E E E E E E W
W W W W W W W W W G W W W W W W W W W W
