WWWWWWWWWWWWWWWWWWWW
WEEEEEEEEEEEEEEEEEEW
WEETEEEEEWEEEEEEEEEW
WETTTEEEEWEEETETEEEW
WETTTEEEEWEETETETEEW
WETTTEEEEWEEETETEEEW
WEETEEEEEGEETETETEEW
WEEEEEEEEWEEETETEEEW
WEEEEEEEEWEEEEEEEEEW
WEEVEEEEEWEEEEEEEEEW
WEEEEEEEEWEEEEEEEEEW
WWWWWWWWWWWWWWWWWWWW
