W W W W W W W W W W W W W W W W W W W W
W E E E E E E E E E E E E E E E E E E W
W E E T E E E E E W E E E E E E E E E W
W E T T T E E E E W E E E T E T E E E W
W E T T T E E E E W E E T E T E T E E W
W E T T T E E E E W E E E T E T E E E W
W E E T E E E E E G E E T E T E T E E W
W E E E E E E E E W E E E T E T E E E W
W E E E E E E E E W E E E E E E E E E W
W E E V E E E E E W E E E E E E E E E W
W E E E E E E E E W E E E E E E E E E W
W W W W W W W W W W W W W W W W W W W W
