WWWWWWWWWGWWWWWWWWWW
WETETETETETETETETEEW
WEEEEEEEEEEEEEEEEEEW
WEEEEEEEEEEEEEEEEEEW
WEEEEEEEEEEEEEEEEEEW
WVEEEEEEETEEEEEEEEEW
WEEEEEEETTTEEEEEEEEW
WEEEEEETTTTTEEEEEEEW
WEEWEETTTWTTTEEWEEEW
WEEWETTTTWTTTTEWEEEW
WEEWTTTTTTTTTTTWEEEW
WWWWWWWWWWWWWWWWWWWW
