W W W W W W W W W G W W W W W W W W W W
W E T E T E T E T E T E T E T E T E E W
W E E E E E E E E E E E E E E E E E E W
W E E E E E E E E E E E E E E E E E E W
W E E E E E E E E E E E E E E E E E E W
W V E E E E E E E T E E E E E E E E E W
W E E E E E E E T T T E E E E E E E E W
W E E E E E E T T T T T E E E E E E E W
W E E W E E T T T W T T T E E W E E E W
W E E W E T T T T W T T T T E W E E E W
W E E W T T T T T T T T T T T W E E E W
W W W W W W W W W W W W W W W W W W W W
