WWWWWWWWWWWWWWWWWWWW
WEEEEEEEEEEEEEEEEEEW
WETTTTTTTTTTTTTTTTEW
WEEEEEEEEEEEEEEEEEEW
WEETETETEWEETETETEEW
WVEETETEEWEEETETEEEW
WEETETETEWEETETETEEW
WEEETETEEWEEETETEEEW
GEETETETEWEETETETEEW
WEEEEEEEEWEEEEEEEEEW
WEEEEEEEETEEEEEEEEEW
WWWWWWWWWWWWWWWWWWWW
