WWWWWWWWWWWWWWWWWWWW
WEEEEEEEEEEEETEEEEEW
WEEEEEEETTTEEWETEEEW
WEEEEEETTTTTEWETEEEW
WEEEEEETTTTTEWETEEEW
WVEEEEETTTTTEWETEEEW
WEEEEEETTTTTEWETEEEW
WEEEEEETTTTTEWETEEEW
WEEEEEEETTTEEWETEEEW
WWWWWWWWWWWWWWETEEEW
GEETTTTTTTTTEEEEEEEW
WWWWWWWWWWWWWWWWWWWW
