W W W W W W W W W W W W W W W W W W W W
W E E E E E E E E E E E E T E E E E E W
W E E E E E E E T T T E E W E T E E E W
W E E E E E E T T T T T E W E T E E E W
W E E E E E E T T T T T E W E T E E E W
W V E E E E E T T T T T E W E T E E E W
W E E E E E E T T T T T E W E T E E E W
W E E E E E E T T T T T E W E T E E E W
W E E E E E E E T T T E E W E T E E E W
W W W W W W W W W W W W W W E T E E E W
G E E T T T T T T T T T E E E E E E E W
W W W W W W W W W W W W W W W W W W W W
