W W W W W W W W W G W W W W W W W W W W
W E E E E E E E E E E E E E E E E E E W
W E E E E E E E E E E E E E E E E E E W
W E E E E E E E T T T E E E T E T E E W
W E E E W E E T E T E T E E E E E E E W
W V E E E E E T T E T T E E E T E T E W
W E E E W E E T E T E T E E E E E E E W
W E E E E E E T T E T T E E T E T E E W
W E E E W E E T E W E T E E E E E E E W
W E E E E E E E T W T E E E E T E T E W
W E E E E E E E E W E E E E E E E E E W
W W W W W W W W W W W W W W W W W W W W
