WWWWWWWWWGWWWWWWWWWW
WEEEEEEEEEEEEEEEEEEW
WEEEEEEEEEEEEEEEEEEW
WEEEEEEETTTEEETETEEW
WEEEWEETETETEEEEEEEW
WVEEEEETTETTEEETETEW
WEEEWEETETETEEEEEEEW
WEEEEEETTETTEETETEEW
WEEEWEETEWETEEEEEEEW
WEEEEEEETWTEEEETETEW
WEEEEEEEEWEEEEEEEEEW
WWWWWWWWWWWWWWWWWWWW
