WWWWWWWWWWWWWWWWWWWW
WEEEEEEEEEEEEEEEEEEW
WEETEWWWWEWWWWETEEEW
WEETEWEEEEEEEWETEEEW
WEETEWEETETEEWETEEEW
WVETEWETETETEWETEEEW
WEETEWEETETEEWETEEEW
WEETEWEEETEEEWETEEEW
WEETEWETEEETEWETEEEW
WEETEWWWWWWWWWETEEEW
WEEEEEEEEGEEEEEEEEEW
WWWWWWWWWWWWWWWWWWWW
