W W W W W W W W W W W W W W W W W W W W
W E E E E E E E E E E E E E E E E E E W
W E E T E W W W W E W W W W E T E E E W
W E E T E W E E E E E E E W E T E E E W
W E E T E W E E T E T E E W E T E E E W
W V E T E W E T E T E T E W E T E E E W
W E E T E W E E T E T E E W E T E E E W
W E E T E W E E E T E E E W E T E E E W
W E E T E W E T E E E T E W E T E E E W
W E E T E W W W W W W W W W E T E E E W
W E E E E E E E E G E E E E E E E E E W
W W W W W W W W W W W W W W W W W W W W
