WWWWWWWWWWWWWWWWWWWW
WTTTTTTTTTTTTTTTTTTW
WEEEEEEEETTEEEEEEEEW
WEEEEEEWWWWWWEEEEEEW
WEEEEEEWEEEEWEEEEEEW
WEETTEEWETTEWEETTEEW
WETTTTEWETTEWETTTTEW
WETTTTEWETTEWETTTTEW
WEETTEEWETTEWEETTEEW
WEEEEEEWWEEWWEEEEEEW
WEEEEEEEEVEEEEEEEEEW
WWWWWWWWWGWWWWWWWWWW
