W W W W W W W W W W W W W W W W W W W W
W T T T T T T T T T T T T T T T T T T W
W E E E E E E E E T T E E E E E E E E W
W E E E E E E W W W W W W E E E E E E W
W E E E E E E W E E E E W E E E E E E W
W E E T T E E W E T T E W E E T T E E W
W E T T T T E W E T T E W E T T T T E W
W E T T T T E W E T T E W E T T T T E W
W E E T T E E W E T T E W E E T T E E W
W E E E E E E W W E E W W E E E E E E W
W E E E E E E E E V E E E E E E E E E W
W W W W W W W W W G W W W W W W W W W W
