W W W W W W W W W W W W W W W W W W W W
W E E T E E E T E T E T E E E T E E E W
W E E T E E E E T E T E E E E T E E E W
W E E T E W E E E T E E E W E T E E E W
W E E T E W E E E T E E E W E T E E E W
W V E T E W E E W G W E E W E T E E E W
W E E T E W T E W T W E T W E T E E E W
W E E T E W E E W T W E E W E T E E E W
W E E T E W E E W T W E E W E T E E E W
W E E T E W E E W T W E E W E T E E E W
W E E T E E E E E E E E E E E T E E E W
W W W W W W W W W W W W W W W W W W W W
