WWWWWWWWWWWWWWWWWWWW
WEETEEETETETEEETEEEW
WEETEEEETETEEEETEEEW
WEETEWEEETEEEWETEEEW
WEETEWEEETEEEWETEEEW
WVETEWEEWGWEEWETEEEW
WEETEWTEWTWETWETEEEW
WEETEWEEWTWEEWETEEEW
WEETEWEEWTWEEWETEEEW
WEETEWEEWTWEEWETEEEW
WEETEEEEEEEEEEETEEEW
WWWWWWWWWWWWWWWWWWWW
