W W W W W W W W W W W W W W W W W W W W
W E E E E E E T E W W E T E E E E E E W
W E E E E E E W E T T E W E E E E E E W
W E E T T E W W W W W W W W E T T E E W
W E E T T E W E E T T E E W E T T E E W
W V E T E E E G E E E E T E E E T E E W
W E E T E W T W T E E T W T W E T E E W
W E E T E W T W E T T E W T W E T E E W
W E T T E W T W E T T E W T W E T T E W
W E T T E W T W T T T T W T W E T T E W
W E E E E E E W E E E E W E E E E E E W
W W W W W W W W W W W W W W W W W W W W
