WWWWWWWWWWWWWWWWWWWW
WEEEEEETEWWETEEEEEEW
WEEEEEEWETTEWEEEEEEW
WEETTEWWWWWWWWETTEEW
WEETTEWEETTEEWETTEEW
WVETEEEGEEEETEEETEEW
WEETEWTWTEETWTWETEEW
WEETEWTWETTEWTWETEEW
WETTEWTWETTEWTWETTEW
WETTEWTWTTTTWTWETTEW
WEEEEEEWEEEEWEEEEEEW
WWWWWWWWWWWWWWWWWWWW
