WWWWWWWWWGWWWWWWWWWW
WEEEEEEEEEEEEEEEEEEW
WETTTTTTTTTTTTTTTTEW
WETEEEEEEEEEEEEEETEW
WETEEEEEEEEEEEEEETEW
WVTEEEEEEEEEEEEEETEW
WETETEEEEEEEEEETETEW
WETEWWWWWTWWWWWWETEW
WETEWTTTTETTTTTWETEW
WETEWTTTTETTTTTWETEW
WEEEWTTTTETTTTTWEEEW
WWWWWWWWWWWWWWWWWWWW
