W W W W W W W W W G W W W W W W W W W W
W E E E E E E E E E E E E E E E E E E W
W E T T T T T T T T T T T T T T T T E W
W E T E E E E E E E E E E E E E E T E W
W E T E E E E E E E E E E E E E E T E W
W V T E E E E E E E E E E E E E E T E W
W E T E T E E E E E E E E E E T E T E W
W E T E W W W W W T W W W W W W E T E W
W E T E W T T T T E T T T T T W E T E W
W E T E W T T T T E T T T T T W E T E W
W E E E W T T T T E T T T T T W E E E W
W W W W W W W W W W W W W W W W W W W W
