WWWWWWWWWWWWWWWWWWWW
WWTTWWEEEEEEEEEEETTW
WWTTTWEEETEEEEEEETTW
WWTTTWEETETEEEEEEWWW
WWWTTWEEETETTTEEEEEW
WVEEEEEEEETTWWETEEEW
WEEEEEEETTWWWEEEEEEW
WEEEEETTWWWTETEEEETW
WEEETTWWWTEEEEEEEWWW
WEETWWWTEETETETEETTW
WETWWEEETEEETTTEETTW
WWWWWWWGWWWWWWWWWWWW
