W W W W W W W W W W W W W W W W W W W W
W W T T W W E E E E E E E E E E E T T W
W W T T T W E E E T E E E E E E E T T W
W W T T T W E E T E T E E E E E E W W W
W W W T T W E E E T E T T T E E E E E W
W V E E E E E E E E T T W W E T E E E W
W E E E E E E E T T W W W E E E E E E W
W E E E E E T T W W W T E T E E E E T W
W E E E T T W W W T E E E E E E E W W W
W E E T W W W T E E T E T E T E E T T W
W E T W W E E E T E E E T T T E E T T W
W W W W W W W G W W W W W W W W W W W W
