W W W W W W W W W W W W W W W W W W W W
W T T T E T E T E E T E E E E E E E E W
W E T E E T E T E T E E E E E E E E E W
W E T E E T E T T E E E T T T E E E E W
W E T E E T E T E T E E E E E E E E E W
G V T E E T E T E E T E E E E E E E E W
W E E E E E E E E E E E E E E E E E E W
W E E E E E E E T T T E E T E E T E T W
W E E E E E E E E T E E T E T E T T E W
W E E E E E E E E T E E T T T E T E T W
W E E E E E E E E T E E T E T E T E T W
W W W W W W W W W W W W W W W W W W W W
