WWWWWWWWWWWWWWWWWWWW
WTTTETETEETEEEEEEEEW
WETEETETETEEEEEEEEEW
WETEETETTEEETTTEEEEW
WETEETETETEEEEEEEEEW
GVTEETETEETEEEEEEEEW
WEEEEEEEEEEEEEEEEEEW
WEEEEEEETTTEETEETETW
WEEEEEEEETEETETETTEW
WEEEEEEEETEETTTETETW
WEEEEEEEETEETETETETW
WWWWWWWWWWWWWWWWWWWW
