WWWWWWWWWWWWWWWWWWWW
WEEEEEEEETEEEEEEEEEW
WEEEWWWWWTWWWWWWEEEW
WEEEWTTTEEEETTTWEEEW
WEEEWTTTEWTETTTWEEEW
WVEEGWWWTTWTWWWWEEEW
WEEEWWWWTTWTWWWWEEEW
WEEEWTTTTWTTTTTWEEEW
WEEEWTTTTTTTTTTWEEEW
WEEEWWWWWWWWWWWWEEEW
WEEEEEEEEEEEEEEEEEEW
WWWWWWWWWWWWWWWWWWWW
