W W W W W W W W W W W W W W W W W W W W
W E E E E E E E E T E E E E E E E E E W
W E E E W W W W W T W W W W W W E E E W
W E E E W T T T E E E E T T T W E E E W
W E E E W T T T E W T E T T T W E E E W
W V E E G W W W T T W T W W W W E E E W
W E E E W W W W T T W T W W W W E E E W
W E E E W T T T T W T T T T T W E E E W
W E E E W T T T T T T T T T T W E E E W
W E E E W W W W W W W W W W W W E E E W
W E E E E E E E E E E E E E E E E E E W
W W W W W W W W W W W W W W W W W W W W
