WWWWWWWWWWWWWWWWWWWW
WEEEEEEEEEEEEEEEEEEW
WEEEEWTTTTTTTTTWEEEW
WEEEEEWTTTTTTTWEEEEW
WEEEEEEWTTTTTWEEEEEW
WEEEEEEEWTTTWEEEEEEW
WEEVEEEEEWGWEEEEEEEW
WEEEEEEEETWTEEEEEEEW
WEEEEEEEETWTEEEEEEEW
WEEEEEEEEWWWEEEEEEEW
WEEEEEEETTTTTEEEEEEW
WWWWWWWWWWWWWWWWWWWW
