W W W W W W W W W W W W W W W W W W W W
W E E E E E E E E E E E E E E E E E E W
W E E E E W T T T T T T T T T W E E E W
W E E E E E W T T T T T T T W E E E E W
W E E E E E E W T T T T T W E E E E E W
W E E E E E E E W T T T W E E E E E E W
W E E V E E E E E W G W E E E E E E E W
W E E E E E E E E T W T E E E E E E E W
W E E E E E E E E T W T E E E E E E E W
W E E E E E E E E W W W E E E E E E E W
W E E E E E E E T T T T T E E E E E E W
W W W W W W W W W W W W W W W W W W W W
