WWWWWWWWWWWWWWWWWWWW
WTTTTTTTTTEEEEEEEEEW
WTTTTWWWWTWWWWWEEEEW
WTTWTWTTTTWTTTWEEEEW
WTTTTWTWWWWTWTWEEEEW
WTTTTWTTTTTTWTWEEEEW
WVTWWWWWWWWWTTWEEEEW
WTTTTWTTTTWTTWWEEEEW
WTWWTWTWWTTTTTWEEEEW
WTTTTWTTTWWWTTWEEEEW
WTTTTWTTTTTTTTWEEEEW
WWWWWWWWWWWWWGWWWWWW
