W W W W W W W W W W W W W W W W W W W W
W T T T T T T T T T E E E E E E E E E W
W T T T T W W W W T W W W W W E E E E W
W T T W T W T T T T W T T T W E E E E W
W T T T T W T W W W W T W T W E E E E W
W T T T T W T T T T T T W T W E E E E W
W V T W W W W W W W W W T T W E E E E W
W T T T T W T T T T W T T W W E E E E W
W T W W T W T W W T T T T T W E E E E W
W T T T T W T T T W W W T T W E E E E W
W T T T T W T T T T T T T T W E E E E W
W W W W W W W W W W W W W G W W W W W W
