W W W W W W W W W W W W W W W W W W W W
W E E E E W E E E E E E E G E E E E E W
W E T E E W T E W E W E T W E E E T E W
W E T E E W E E W E W E E W E E T T E W
W E T T E W W W E E E W W W E T T T E W
W E T T E E T E E T E E T E T T T T E W
W V T T E E T E E T E E T E T T T T E W
W E T T E W W W E E E W W W E T T T E W
W E T E E W E E W E W E E W E E T T E W
W E T E E W T E W E W E T W E E E T E W
W E E E E W E E E E E E E W E E E E E W
W W W W W W W W W W W W W W W W W W W W
