WWWWWWWWWWWWWWWWWWWW
WEEEEWEEEEEEEGEEEEEW
WETEEWTEWEWETWEEETEW
WETEEWEEWEWEEWEETTEW
WETTEWWWEEEWWWETTTEW
WETTEETEETEETETTTTEW
WVTTEETEETEETETTTTEW
WETTEWWWEEEWWWETTTEW
WETEEWEEWEWEEWEETTEW
WETEEWTEWEWETWEEETEW
WEEEEWEEEEEEEWEEEEEW
WWWWWWWWWWWWWWWWWWWW
