W W W W W W W W W W W W W W W W W W W W
W T T T T T T T T T T T T T T T T T T W
W T T T T T T T T T T T T T T T T T T W
W T T T T T T T T T T T T T T T T T T W
W T T T T T T T T T T T T T T T T T T W
W V T T T T T T G T T T T T T T T T T W
W T T T T T T T T T T T T T T T T T T W
W T T T T T T T T T T T T T T T T T T W
W T T T T T T T T T T T T T T T T T T W
W T T T T T T T T T T T T T T T T T T W
W T T T T T T T T T T T T T T T T T T W
W W W W W W W W W W W W W W W W W W W W
