WWWWWWWWWWWWWWWWWWWW
WTTTTTTTTTTTTTTTTTTW
WTTTTTTTTTTTTTTTTTTW
WTTTTTTTTTTTTTTTTTTW
WTTTTTTTTTTTTTTTTTTW
WVTTTTTTGTTTTTTTTTTW
WTTTTTTTTTTTTTTTTTTW
WTTTTTTTTTTTTTTTTTTW
WTTTTTTTTTTTTTTTTTTW
WTTTTTTTTTTTTTTTTTTW
WTTTTTTTTTTTTTTTTTTW
WWWWWWWWWWWWWWWWWWWW
