W W W W W W W W W W W W W W W W W W W W
W E E E E E E E E E E E E E E E E E E W
W E E E E T E E E E E T T T T E E E E W
W E E E E W W E E E E W W W W E E E E W
W E E E W T E W E E W T T T T W E E E W
W V E E E E E E W W T T T T T T W E E W
W E E E W W W E E T T T T T T T W E E W
W E E E E E E W E T T T T T T T T W T W
W E E E E E E E W W T T T T T T T G E W
W E E E E E E E W E W W W W W W W E E W
W T T T T T T W W E E E E E W W E T T W
W W W W W W W W W W W W W W W W W W W W
