WWWWWWWWWWWWWWWWWWWW
WEEEEEEEEEEEEEEEEEEW
WEEEETEEEEETTTTEEEEW
WEEEEWWEEEEWWWWEEEEW
WEEEWTEWEEWTTTTWEEEW
WVEEEEEEWWTTTTTTWEEW
WEEEWWWEETTTTTTTWEEW
WEEEEEEWETTTTTTTTWTW
WEEEEEEEWWTTTTTTTGEW
WEEEEEEEWEWWWWWWWEEW
WTTTTTTWWEEEEEWWETTW
WWWWWWWWWWWWWWWWWWWW
