WWWWWWWWWWWWWWWWWWWW
WTTTTWEEEEEEEEWTTTTW
WETEEEWEEEEEEWEEETEW
WTETEEEWEEEEWEEETETW
WWWWTEEEWEEWEEETWWWW
WEEEWTEEEWWEEETWEEEW
WTTEEWTEEVEEETWEETTW
WTWTEEWTETTETWEETWTW
WEEWTEEWETTEWEETWEEW
WETEWTEEWTTWEETWETEW
WEEEEWTEETTEETWEEEEG
WWWWWWWWWWWWWWWWWWWW
