W W W W W W W W W W W W W W W W W W W W
W T T T T W E E E E E E E E W T T T T W
W E T E E E W E E E E E E W E E E T E W
W T E T E E E W E E E E W E E E T E T W
W W W W T E E E W E E W E E E T W W W W
W E E E W T E E E W W E E E T W E E E W
W T T E E W T E E V E E E T W E E T T W
W T W T E E W T E T T E T W E E T W T W
W E E W T E E W E T T E W E E T W E E W
W E T E W T E E W T T W E E T W E T E W
W E E E E W T E E T T E E T W E E E E G
W W W W W W W W W W W W W W W W W W W W
