W W W W W W W W W W W W W W W W W W W W
W V T T T T T T E T W T E T T T T T T W
W E T T T T T T T T W T T T T T T T T W
W T T T T T T E T E W E T E T T T T T W
W E T T T T E T W W W W W T E T E T T W
W T T T T E W E W E E E W E W E T T T W
W E T T T E W E W E T E W E W E T T T W
W E E T E E W E W E E E W E W E E T E W
W E T T T T W E W W E W W E W T T T T W
W T T T T W W E E E E E E E W W T T T W
G E T E T E W T T T T T T T W E T E T W
W W W W W W W W W W W W W W W W W W W W
