WWWWWWWWWWWWWWWWWWWW
WVTTTTTTETWTETTTTTTW
WETTTTTTTTWTTTTTTTTW
WTTTTTTETEWETETTTTTW
WETTTTETWWWWWTETETTW
WTTTTEWEWEEEWEWETTTW
WETTTEWEWETEWEWETTTW
WEETEEWEWEEEWEWEETEW
WETTTTWEWWEWWEWTTTTW
WTTTTWWEEEEEEEWWTTTW
GETETEWTTTTTTTWETETW
WWWWWWWWWWWWWWWWWWWW
