W W W W W W W W W W W W W W W W W W W W
W E E E E T T T T E E T T E E E E E E W
W E E E T W W W W T E T T E E E E E E W
W E E T W W W W W W T T T E E E E E E W
W E T W W W W W W W W T T E E E E E E W
W V T W T T T W W W W W T E E E E E E W
W E T W T T T T T T T W T E T E T E T W
W E T W T T T T T T T W T T T T T T T W
W E T W W W W W T T T W T E T E T E T W
W E T W W W W W T T W W T E T E T E T W
W E T T T T T T T T T T T E T E T E T G
W W W W W W W W W W W W W W W W W W W W
