WWWWWWWWWWWWWWWWWWWW
WEEEETTTTEETTEEEEEEW
WEEETWWWWTETTEEEEEEW
WEETWWWWWWTTTEEEEEEW
WETWWWWWWWWTTEEEEEEW
WVTWTTTWWWWWTEEEEEEW
WETWTTTTTTTWTETETETW
WETWTTTTTTTWTTTTTTTW
WETWWWWWTTTWTETETETW
WETWWWWWTTWWTETETETW
WETTTTTTTTTTTETETETG
WWWWWWWWWWWWWWWWWWWW
