WWWWWWWWWWWWWWWWWWWW
WETEEWEWEEEWEWEEETEW
WETEEWEWEEEWEWEEETEW
WWWWEWEWETEWEWEWWWWW
WETEEWEWETEWEWEEETEW
WEWWWWEWEEEWEWWWWWEW
WETEEEEWEEEWEEEEETEW
WEWWWWEWWVWWEWWWWWEW
WETEEWEETETEEWEEETEW
WEEEEWTEEEEETWEEEEEW
WETEEWTTTTTTTWEEETEW
WWWWWWWWWGWWWWWWWWWW
