W W W W W W W W W W W W W W W W W W W W
W E T E E W E W E E E W E W E E E T E W
W E T E E W E W E E E W E W E E E T E W
W W W W E W E W E T E W E W E W W W W W
W E T E E W E W E T E W E W E E E T E W
W E W W W W E W E E E W E W W W W W E W
W E T E E E E W E E E W E E E E E T E W
W E W W W W E W W V W W E W W W W W E W
W E T E E W E E T E T E E W E E E T E W
W E E E E W T E E E E E T W E E E E E W
W E T E E W T T T T T T T W E E E T E W
W W W W W W W W W G W W W W W W W W W W
