W W W W W W W W W W W W W W W W W W W W
W V T T T T T T T T T T T T T T T T T W
W E T E T E T E T E E T E T E T E T E W
W W T T T T T T T T T T T T T T T T W W
W W T T W T T E T E E T E T T W T T W W
W W T T W T T W T W T T W T T W T T W W
W W T T W T T W T W T T W T T W T T W W
W W T T W T T W T W T T W T T W T T W W
W W T T W T T W T W T T W T T W T T W W
W W T T W T T W T W T T W T T W T T W W
W W T T W T T W T W T T W T T W T T W W
W W W W W W W W G W W W W W W W W W W W
