WWWWWWWWWWWWWWWWWWWW
WVTTTTTTTTTTTTTTTTTW
WETETETETEETETETETEW
WWTTTTTTTTTTTTTTTTWW
WWTTWTTETEETETTWTTWW
WWTTWTTWTWTTWTTWTTWW
WWTTWTTWTWTTWTTWTTWW
WWTTWTTWTWTTWTTWTTWW
WWTTWTTWTWTTWTTWTTWW
WWTTWTTWTWTTWTTWTTWW
WWTTWTTWTWTTWTTWTTWW
WWWWWWWWGWWWWWWWWWWW
