W W W W W W W W W W W W W W W W W W W W
W W W W W W E E E E E E T E T E W W W W
W W T T T W E E E T T T T T W T E W W W
W W T T T E E E T W W T T T T W T E W W
W W T T T E E T W E E W T T T T W T E W
W W T T T E T W E E E E W T T T T W E W
W W W W E T W E E E E E E W T T T T E W
W E E E T W E E E E E E E E W T T T T W
W E E T W E E E E E E E E E E W T T T W
W E T W E E E E E E E E E E E E W T T W
W T V W E E E E E E E E E E E E W G T W
W W W W W W W W W W W W W W W W W W W W
