WWWWWWWWWWWWWWWWWWWW
WWWWWWEEEEEETETEWWWW
WWTTTWEEETTTTTWTEWWW
WWTTTEEETWWTTTTWTEWW
WWTTTEETWEEWTTTTWTEW
WWTTTETWEEEEWTTTTWEW
WWWWETWEEEEEEWTTTTEW
WEEETWEEEEEEEEWTTTTW
WEETWEEEEEEEEEEWTTTW
WETWEEEEEEEEEEEEWTTW
WTVWEEEEEEEEEEEEWGTW
WWWWWWWWWWWWWWWWWWWW
