W W W W W W W W W W W W W W W W W W W W
W V T W W E T E E W E E T E E E E E E W
W E E E W E W E W T E W W W W W E W E W
W W W E W E W E E E E E E E E W E E E W
W E E T E E W E W E W W E W W E T E E W
W E W W W W W T W G W E T E E W E W E W
W E E E E W E E W T E T E W T E E E E W
W W W W E W E W W E W E T W E W T T E W
W E E E E W E T E W E T E W E T E E W W
W E W W E W W E E E W E E W T E E W E W
W E T E E E W E E E W E W E W E W E E W
W W W W W W W W W W W W W W W W W W W W
