WWWWWWWWWWWWWWWWWWWW
WVTWWETEEWEETEEEEEEW
WEEEWEWEWTEWWWWWEWEW
WWWEWEWEEEEEEEEWEEEW
WEETEEWEWEWWEWWETEEW
WEWWWWWTWGWETEEWEWEW
WEEEEWEEWTETEWTEEEEW
WWWWEWEWWEWETWEWTTEW
WEEEEWETEWETEWETEEWW
WEWWEWWEEEWEEWTEEWEW
WETEEEWEEEWEWEWEWEEW
WWWWWWWWWWWWWWWWWWWW
