WWWWWWWWWWWWWWWWWWWW
WEEEEEEEEGEEEEEEEEEW
WEEEWWEEEEEEEEWWEEEW
WEEWTTWEEEEEEWTTWEEW
WEWTTTTWEWWEWTTTTWEW
WVWTTTEEETTEEETTTWEW
WEWTTTETTTTTWETTTWEW
WEWTTTTWWWWWWTTTTWEW
WEEWTTWEEEEEEWTTWEEW
WEEEWWEEEEEEEEWWEEEW
WEEEEEEEEEEEEEEEEEEW
WWWWWWWWWWWWWWWWWWWW
