W W W W W W W W W W W W W W W W W W W W
W E E E E E E E E G E E E E E E E E E W
W E E E W W E E E E E E E E W W E E E W
W E E W T T W E E E E E E W T T W E E W
W E W T T T T W E W W E W T T T T W E W
W V W T T T E E E T T E E E T T T W E W
W E W T T T E T T T T T W E T T T W E W
W E W T T T T W W W W W W T T T T W E W
W E E W T T W E E E E E E W T T W E E W
W E E E W W E E E E E E E E W W E E E W
W E E E E E E E E E E E E E E E E E E W
W W W W W W W W W W W W W W W W W W W W
