W W W W W W W W W W W W W W W W W W W W
W E E E E W E E E E W E E E W E E E E W
W E E T:tree E W E T:tree E E W E T:elephant E W E T:tree E E W
W E E E E W E E E E W E E E W E E E E W
W W W E W W W E W W V W E W W W E W W W
W T:tree E E E T:tree E E E E T:tree E E E T:tree E E E T:tree W
W T:tree E E E T:tree E E E E T:tree E E E T:tree E E E T:tree W
W W W E W W W E W W G W E W W W E W W W
W E E E E W E E E W E E E E W E E E E W
W E E T:tree E W E T:elephant E W E E T:tree E W E T:tree E E W
W E E E E W E E E W E E E E W E E E E W
W W W W W W W W W W W W W W W W W W W W
