W W W W W W W W W W W W W W W W W W W W
W E E E E W E E E E W E E E W E E E E W
W E E T E W E T E E W E T E W E T E E W
W E E E E W E E E E W E E E W E E E E W
W W W E W W W E W W V W E W W W E W W W
W T E E E T E E E E T E E E T E E E T W
W T E E E T E E E E T E E E T E E E T W
W W W E W W W E W W G W E W W W E W W W
W E E E E W E E E W E E E E W E E E E W
W E E T E W E T E W E E T E W E T E E W
W E E E E W E E E W E E E E W E E E E W
W W W W W W W W W W W W W W W W W W W W
