WWWWWWWWWWWWWWWWWWWW
WEEEEWEEEEWEEEWEEEEW
WEETEWETEEWETEWETEEW
WEEEEWEEEEWEEEWEEEEW
WWWEWWWEWWVWEWWWEWWW
WTEEETEEEETEEETEEETW
WTEEETEEEETEEETEEETW
WWWEWWWEWWGWEWWWEWWW
WEEEEWEEEWEEEEWEEEEW
WEETEWETEWEETEWETEEW
WEEEEWEEEWEEEEWEEEEW
WWWWWWWWWWWWWWWWWWWW
