WWWWWWWWWWWWWWWWWWWW
WEEEEEEEEEEEEEEEEEEW
WEEWWWWWWWWWWWWWWEEW
WEEWTTTTTWWTTTTTWEEW
WEEWTWTTTWWTTTWTWEEW
WEEWTWWTTWWTTWWTWEEW
WEEWTTWWTWWTWWTTWEEW
WEEWTTTWTWWTWTTTWEEW
WEEWTTTTTWWTTTTTWEEW
WEEWWWWTTWWTTWWWWEEW
WVEEEEEEEEEEEEEEEEEG
WWWWWWWWWWWWWWWWWWWW
