W W W W W W W W W W W W W W W W W W W W
W E E E E E E E E E E E E E E E E E E W
W E E W W W W W W W W W W W W W W E E W
W E E W T T T T T W W T T T T T W E E W
W E E W T W T T T W W T T T W T W E E W
W E E W T W W T T W W T T W W T W E E W
W E E W T T W W T W W T W W T T W E E W
W E E W T T T W T W W T W T T T W E E W
W E E W T T T T T W W T T T T T W E E W
W E E W W W W T T W W T T W W W W E E W
W V E E E E E E E E E E E E E E E E E G
W W W W W W W W W W W W W W W W W W W W
