WWWWWWWWWWWWWWWWWWWW
WETETETETTTTETETETEW
WEWWWWWWWWWWWWWWWWEW
WETETETETTTTETETETEW
WEWWWWWWWWWWWWWWWWEW
WVTETETETTTTETETETEW
WEWWWWWWWWWWWWWWWWEW
WETETETETTTTETETETEW
WEWWWWWWWWWWWWWWWWEW
WETETETETTTTETETETEW
WEWWWWWWWGWWWWWWWWEW
WWWWWWWWWWWWWWWWWWWW
