W W W W W W W W W W W W W W W W W W W W
W E T E T E T E T T T T E T E T E T E W
W E W W W W W W W W W W W W W W W W E W
W E T E T E T E T T T T E T E T E T E W
W E W W W W W W W W W W W W W W W W E W
W V T E T E T E T T T T E T E T E T E W
W E W W W W W W W W W W W W W W W W E W
W E T E T E T E T T T T E T E T E T E W
W E W W W W W W W W W W W W W W W W E W
W E T E T E T E T T T T E T E T E T E W
W E W W W W W W W G W W W W W W W W E W
W W W W W W W W W W W W W W W W W W W W
