WWWWWWWWWWWWWWWWWWWW
WEEEWTTTTWWTTTTWTTWW
WEEWTTWTTWTTWTTWTTTW
WTWTTWTTWTTWTTWTTWTW
WTTTWTTWTTWTTWTTWTTW
WVTWWTWWTWWTWWTWWTWW
WTTTWTTWTTWTTWTTWTTW
WTWTTWTTWTTWTTWTTWTG
WTTWTTWTTWTTWTTWTTWW
WWTTWTTWTTWTTWTTWTTW
WWWTTTTWWTTTTWWTTTTW
WWWWWWWWWWWWWWWWWWWW
