W W W W W W W W W W W W W W W W W W W W
W E E E W T T T T W W T T T T W T T W W
W E E W T T W T T W T T W T T W T T T W
W T W T T W T T W T T W T T W T T W T W
W T T T W T T W T T W T T W T T W T T W
W V T W W T W W T W W T W W T W W T W W
W T T T W T T W T T W T T W T T W T T W
W T W T T W T T W T T W T T W T T W T G
W T T W T T W T T W T T W T T W T T W W
W W T T W T T W T T W T T W T T W T T W
W W W T T T T W W T T T T W W T T T T W
W W W W W W W W W W W W W W W W W W W W
