W W W W W W W W W W W W W W W W W W W W
W E T W W W T E E T T E E T T T T E E W
W E T W W W T E T W W T E T W W W T E W
W E E T W T E T W W W W T T W W W T E W
W E E T W T E T W W W W T T W W W T E W
W V E E T E E T W W W W T T W W W T E W
W E E E T E E T W W W W T T T T T E E G
W E E T W T E T W W W W T T W T E E E W
W E E T W T E T W W W W T T W W T E E W
W E T W W W T E T W W T E T W W W T E W
W E T W W W T E E T T E E T W W W T E W
W W W W W W W W W W W W W W W W W W W W
