WWWWWWWWWWWWWWWWWWWW
WETWWWTEETTEETTTTEEW
WETWWWTETWWTETWWWTEW
WEETWTETWWWWTTWWWTEW
WEETWTETWWWWTTWWWTEW
WVEETEETWWWWTTWWWTEW
WEEETEETWWWWTTTTTEEG
WEETWTETWWWWTTWTEEEW
WEETWTETWWWWTTWWTEEW
WETWWWTETWWTETWWWTEW
WETWWWTEETTEETWWWTEW
WWWWWWWWWWWWWWWWWWWW
