W W W W W W W W W W W W W W W W W W W W
W E E E E E E E E V E E E E E E E E E W
W E E E W T T T T T T T T T T W E E E W
W E E E W W T T T T T T T T W W E E E W
W E E E W W W T T T T T T W W W E E E W
W E E E W W W W T T T T W W W W E E E W
W E E E W W W W W T T W W W W W E E E W
W E E E W W W W T T T T W W W W E E E W
W E E E W W W T T T T T T W W W E E E W
W E E E W W T T T T T T T T W W E E E W
W E E E W W T T T T T T T T W W E E E W
W W W W W W W W W G W W W W W W W W W W
