WWWWWWWWWWWWWWWWWWWW
WEEEEEEEEVEEEEEEEEEW
WEEEWTTTTTTTTTTWEEEW
WEEEWWTTTTTTTTWWEEEW
WEEEWWWTTTTTTWWWEEEW
WEEEWWWWTTTTWWWWEEEW
WEEEWWWWWTTWWWWWEEEW
WEEEWWWWTTTTWWWWEEEW
WEEEWWWTTTTTTWWWEEEW
WEEEWWTTTTTTTTWWEEEW
WEEEWWTTTTTTTTWWEEEW
WWWWWWWWWGWWWWWWWWWW
