WWWWWWWWWWWWWWWWWWWW
WEEEEEEEETEEEEEEEEEW
WEEEEEEEWGWEEEEEEEEW
WEEEEEEWTETWEEEEEEEW
WEEEEEWTTETTWEEEEEEW
WVEEEWTTTETTTWEEEEEW
WEEEEWTTTETTTWEEEEEW
WEEEEEWTTETTWEEEEEEW
WEEEEEEWTETWEEEEEEEW
WEEEEEEEWEWEEEEEEEEW
WTTTTTTTTTTTTTTTTTTW
WWWWWWWWWWWWWWWWWWWW
