W W W W W W W W W W W W W W W W W W W W
W E E E E E E E E T E E E E E E E E E W
W E E E E E E E W G W E E E E E E E E W
W E E E E E E W T E T W E E E E E E E W
W E E E E E W T T E T T W E E E E E E W
W V E E E W T T T E T T T W E E E E E W
W E E E E W T T T E T T T W E E E E E W
W E E E E E W T T E T T W E E E E E E W
W E E E E E E W T E T W E E E E E E E W
W E E E E E E E W E W E E E E E E E E W
W T T T T T T T T T T T T T T T T T T W
W W W W W W W W W W W W W W W W W W W W
