WWWWWWWWWWWWWWWWWWWW
WWVWEEEWEEEWEEEWEEEW
WWEWETEWETEWETEWETEW
WWEWEWEWEWEWEWEWEWEW
WWEWEWEWEWEWEWEWEWEW
WWEWEWEWEWEWEWEWEWEW
WWEWEWEWEWEWEWEWEWEW
WWEWEWEWEWEWEWEWEWEW
WWEWEWEWEWEWEWEWEWEW
WWETEWETEWETEWETEWEW
WWETEWEEEWEEEWETEWEW
WWWWWWWWWWWWWWWGWWWW
