W W W W W W W W W W W W W W W W W W W W
W W V W E E E W E E E W E E E W E E E W
W W E W E T E W E T E W E T E W E T E W
W W E W E W E W E W E W E W E W E W E W
W W E W E W E W E W E W E W E W E W E W
W W E W E W E W E W E W E W E W E W E W
W W E W E W E W E W E W E W E W E W E W
W W E W E W E W E W E W E W E W E W E W
W W E W E W E W E W E W E W E W E W E W
W W E T E W E T E W E T E W E T E W E W
W W E T E W E E E W E E E W E T E W E W
W W W W W W W W W W W W W W W G W W W W
