W W W W W W W W W W W W W W W W W W W W
W W V W E E E W E E E W E E E W E E E W
W W E W E T:tree E W E T:tree E W E T:tree E W E T:tree E W
W W E W E W E W E W E W E W E W E W E W
W W E W E W E W E W E W E W E W E W E W
W W E W E W E W E W E W E W E W E W E W
W W E W E W E W E W E W E W E W E W E W
W W E W E W E W E W E W E W E W E W E W
W W E W E W E W E W E W E W E W E W E W
W W E T:tree E W E T:tree E W E T:tree E W E T:tree E W E W
W W E T:diamond E W E E E W E E E W E T:diamond E W E W
W W W W W W W W W W W W W W W G W W W W
