WWWWWWWWWWWWWWWWWWWW
WEEEWTTTTTTTTTTWEEEW
WEEEWTTTTTTTTTTWEEEW
WETEWTTWTTTTWTTWETEW
WEEEWTTWTTTTWTTWEEEW
WVTEETWWWTTWWWTEETEG
WEEEWTTWTTTTWTTWEEEW
WETEWTTWTTTTWTTWETEW
WEEEWTTTTTTTTTTWEEEW
WEEEWTTTTTTTTTTWEEEW
WEEEWWWWWWWWWWWWEEEW
WWWWWWWWWWWWWWWWWWWW
