W W W W W W W W W W W W W W W W W W W W
W E E E W T T T T T T T T T T W E E E W
W E E E W T T T T T T T T T T W E E E W
W E T E W T T W T T T T W T T W E T E W
W E E E W T T W T T T T W T T W E E E W
W V T E E T W W W T T W W W T E E T E G
W E E E W T T W T T T T W T T W E E E W
W E T E W T T W T T T T W T T W E T E W
W E E E W T T T T T T T T T T W E E E W
W E E E W T T T T T T T T T T W E E E W
W E E E W W W W W W W W W W W W E E E W
W W W W W W W W W W W W W W W W W W W W
