W W W W W W W W W W W W W W W W W W W W
W E E E E E E E E E E E E E E E E E E W
W E E E E E E E T E E T E E E E E E E W
W E E T E E E T W T T W T E E E T E E W
W E E E E E T W E E E E W T E E E E E W
W V E E E T W E E W T E E W T E E E E W
W E E E T W E E E W T E E E W T E E E W
W E E T W T E T E E W E T E T W T E E W
W E T W E E W W T T W T W W E E W T E W
W E W E E E W E E W E E E W E E E W T G
W W E E E E W E E W E E E W E E E W W W
W W W W W W W W W W W W W W W W W W W W
