WWWWWWWWWWWWWWWWWWWW
WEEEEEEEEEEEEEEEEEEW
WEEEEEEETEETEEEEEEEW
WEETEEETWTTWTEEETEEW
WEEEEETWEEEEWTEEEEEW
WVEEETWEEWTEEWTEEEEW
WEEETWEEEWTEEEWTEEEW
WEETWTETEEWETETWTEEW
WETWEEWWTTWTWWEEWTEW
WEWEEEWEEWEEEWEEEWTG
WWEEEEWEEWEEEWEEEWWW
WWWWWWWWWWWWWWWWWWWW
