WWWWWWWWWWWWWWWWWWWW
WEEEEEEEEEEEEEEEEEEW
WEEEEEEETEETEEEEEEEW
WEETEEETWTTWTEEETEEW
WEEEEETWEEEEWTEEEEEW
WVEEETWEEWTEEWTEEEEW
WEEETWEEEWTEEEWTEEEW
WEETWTETEWWETETWTEEW
WETWEEWWTTWTWWEEWTEW
WEWEEEWEEWEEEWEEEWTG
WWEEEEWEEWEEEWEEEWWW
WWWWWWWWWWWWWWWWWWWW
