WWWWWWWWWWWWWWWWWWWW
WVEEEEEEEEEEEEEEEEEW
WTTTTTTWEETTTTTTTWEW
WETTWETTWEETTWEETWEW
WETTWETTWEETTWEETWEW
WETTWETTWEETTWTWEEEW
WETTTTTWEEETTTTWEEEW
WETTWEEEEEETTWTWEEEW
WETTWEEEEEETTWEEEEEW
WETTWEEEEEETTWEEEEEW
WTTTWWEEEETTTWWEEEEG
WWWWWWWWWWWWWWWWWWWW
