W W W W W W W W W W W W W W W W W W W W
W V E E E E E E E E E E E E E E E E E W
W T T T T T T W E E T T T T T T T W E W
W E T T W E T T W E E T T W E E T W E W
W E T T W E T T W E E T T W E E T W E W
W E T T W E T T W E E T T W T W E E E W
W E T T T T T W E E E T T T T W E E E W
W E T T W E E E E E E T T W T W E E E W
W E T T W E E E E E E T T W E E E E E W
W E T T W E E E E E E T T W E E E E E W
W T T T W W E E E E T T T W W E E E E G
W W W W W W W W W W W W W W W W W W W W
