W W W W W W W W W W W W W W W W W W W W
W W W W W W W W T T T T T T T W W W W W
W W W W W W W T T T T T T T T W W W W W
W W W W W W T T T T T T T T T W W W W W
W W W W W T T T T T T T T T T W W W W W
W W W W V T T T T T T T T T T W W W W W
W W W W W T T T T T T T T T T W W W W W
W W W W W T T T W T T T T T W W W W W W
W W W W W T T T T T T T T W W W W W W W
W W W W W T T T T T T T W W W W W W W W
W W W W W W W W W W W G W W W W W W W W
W W W W W W W W W W W W W W W W W W W W
