WWWWWWWWWWWWWWWWWWWW
WWWWWWWWTTTTTTTWWWWW
WWWWWWWTTTTTTTTWWWWW
WWWWWWTTTTTTTTTWWWWW
WWWWWTTTTTTTTTTWWWWW
WWWWVTTTTTTTTTTWWWWW
WWWWWTTTTTTTTTTWWWWW
WWWWWTTTTTTTTTTWWWWW
WWWWWTTTWTTTTTWWWWWW
WWWWWTTTTTTTTWWWWWWW
WWWWWTTTTTTTWWWWWWWW
WWWWWWWWWWWGWWWWWWWW
