W W W W W W W W W W W W W W W W W W W W
W E E E E E E E E E E E E E E E E E E W
W T W T W T W T W E E W T W T W T W T W
W T W T W T W T W E E W T W T W T W T W
W T W T W T W T W E E W T W T W T W T W
W T W T W T W T W T E W T W T W T W T W
W T W T W T W T W E T W T W T W T W T W
W T W T W T W T W E E W T W T W T W T W
W T W T W T W T W E E W T W T W T W T W
W T W T W T W T W E E W T W T W T W T W
W E E E E E E E E E V E E E E E E E E W
W W W W W W W W W W G W W W W W W W W W
