WWWWWWWWWWWWWWWWWWWW
WEEEEEEEEEEEEEEEEEEW
WTWTWTWTWEEWTWTWTWTW
WTWTWTWTWEEWTWTWTWTW
WTWTWTWTWEEWTWTWTWTW
WTWTWTWTWTEWTWTWTWTW
WTWTWTWTWETWTWTWTWTW
WTWTWTWTWEEWTWTWTWTW
WTWTWTWTWEEWTWTWTWTW
WTWTWTWTWEEWTWTWTWTW
WEEEEEEEEEVEEEEEEEEW
WWWWWWWWWWGWWWWWWWWW
