W W W W W W W W W W W W W W W W W W W W
W W W W W T T W W W W W W T G W W W W W
W W W W T T T T W W W W W T T W W W W W
W W W E T T T T E W W W W T T W W W W W
W W W W W T T W W W W W W T T W W W W W
W W W W T T T T T T T T T T T T W W W W
W W W W T T T T T T T T T T T T W W W W
W W W W W T T W W W W W W T T W W W W W
W W W W W T T W W W W E T T T T E W W W
W W W W W T T W W W W W T T T T W W W W
W W W W W T V W W W W W W T T W W W W W
W W W W W W W W W W W W W W W W W W W W
