WWWWWWWWWWWWWWWWWWWW
WWWWWTTWWWWWWTGWWWWW
WWWWTTTTWWWWWTTWWWWW
WWWETTTTEWWWWTTWWWWW
WWWWWTTWWWWWWTTWWWWW
WWWWTTTTTTTTTTTTWWWW
WWWWTTTTTTTTTTTTWWWW
WWWWWTTWWWWWWTTWWWWW
WWWWWTTWWWWETTTTEWWW
WWWWWTTWWWWWTTTTWWWW
WWWWWTVWWWWWWTTWWWWW
WWWWWWWWWWWWWWWWWWWW
