WWWWWWWWWWWWWWWWWWWW
WEEETEEETWTEEETEEEEW
WEEWWTEETWTWETWWEEEW
WEEWWWTETWTETWWWEEEW
WEEWWWWTTWTTWWWWEEEW
WVTTTTTTEGETTTTTTTEW
WEEWWWWTTWTTWWWWEEEW
WEEWWWTETWTETWWWEEEW
WEEWWTEWTWTWETWWEEEW
WEEWTEWWTWTWWETWEEEW
WEETEEEETETEEEETEEEW
WWWWWWWWWWWWWWWWWWWW
