W W W W W W W W W W W W W W W W W W W W
W E E E T E E E T W T E E E T E E E E W
W E E W W T E E T W T W E T W W E E E W
W E E W W W T E T W T E T W W W E E E W
W E E W W W W T T W T T W W W W E E E W
W V T T T T T T E G E T T T T T T T E W
W E E W W W W T T W T T W W W W E E E W
W E E W W W T E T W T E T W W W E E E W
W E E W W T E W T W T W E T W W E E E W
W E E W T E W W T W T W W E T W E E E W
W E E T E E E E T E T E E E E T E E E W
W W W W W W W W W W W W W W W W W W W W
