WWWWWWWWWWWWWWWWWWWW
WWETTEWWWWWETTEWWWWW
WETWWTWWEEETWWTETTEW
WTWWWETTEETEWWETEETW
WTWETTTWETWTWETWTWEG
WVWTWWTWTWWTWTWWTWWW
WWWTWWTWTWWTWTWWTWWW
WWWTWTEWTWWTWTWWTWWW
WWWETEWWTWTEWTWTEWWW
WWWWWWWWETEWWETEWWWW
WWWWWWWWWWWWWWWWWWWW
WWWWWWWWWWWWWWWWWWWW
