W W W W W W W W W W W W W W W W W W W W
W W E T T E W W W W W E T T E W W W W W
W E T W W T W W E E E T W W T E T T E W
W T W W W E T T E E T E W W E T E E T W
W T W E T T T W E T W T W E T W T W E G
W V W T W W T W T W W T W T W W T W W W
W W W T W W T W T W W T W T W W T W W W
W W W T W T E W T W W T W T W W T W W W
W W W E T E W W T W T E W T W T E W W W
W W W W W W W W E T E W W E T E W W W W
W W W W W W W W W W W W W W W W W W W W
W W W W W W W W W W W W W W W W W W W W
