WWWWWWWWWWWWWWWWWWWW
WETTEVEETTEEEETTEEEW
WTWWTEETWWTEETWWTEEW
WTWWTEETWWTEETWWTEEW
GETTEEEETTEEEETTEEEW
WWTTWWWWTTWWWWTTWWWW
WWTTWWWWTTWWWWTTWWWW
WETTEEEETTEEEETTEEEW
WTWWTEETWWTEETWWTEEW
WTWWTEETWWTEETWWTEEW
WETTEEEETTEEEEWWEEEW
WWWWWWWWWWWWWWWWWWWW
