W W W W W W W W W W W W W W W W W W W W
W E T T E V E E T T E E E E T T E E E W
W T W W T E E T W W T E E T W W T E E W
W T W W T E E T W W T E E T W W T E E W
G E T T E E E E T T E E E E T T E E E W
W W T T W W W W T T W W W W T T W W W W
W W T T W W W W T T W W W W T T W W W W
W E T T E E E E T T E E E E T T E E E W
W T W W T E E T W W T E E T W W T E E W
W T W W T E E T W W T E E T W W T E E W
W E T T E E E E T T E E E E W W E E E W
W W W W W W W W W W W W W W W W W W W W
