WWWWWWWWWWWWWWWWWWWW
WVETEWTTWETETETEWEEW
WETETWTTWEETETEEWTTW
WEETEWTTEEEETEEEEEEW
WTEEEWTTTETEEETEWWWW
WETEEWWWWEETETEEEEEW
WWWWETETETEWWWWTEEEW
WETEEETETEETTTWTTEEW
WTTWTEETEEEETTWTTTEW
GTTWETEETEEWTTWTTTTW
WTTWTETEEETWTTWTTTTW
WWWWWWWWWWWWWWWWWWWW
