W W W W W W W W W W W W W W W W W W W W
W V E T E W T T W E T E T E T E W E E W
W E T E T W T T W E E T E T E E W T T W
W E E T E W T T E E E E T E E E E E E W
W T E E E W T T T E T E E E T E W W W W
W E T E E W W W W E E T E T E E E E E W
W W W W E T E T E T E W W W W T E E E W
W E T E E E T E T E E T T T W T T E E W
W T T W T E E T E E E E T T W T T T E W
G T T W E T E E T E E W T T W T T T T W
W T T W T E T E E E T W T T W T T T T W
W W W W W W W W W W W W W W W W W W W W
