WWWWWWWWWWWWWWWWWWWW
WEEEETEEEEEEETEEEEEW
WEWWWTWTWTWTWTWWWWEW
WETTTTWTWTWTWTTTTTEW
WEWWWTWTWTWTWTWWWWEW
WETTTTWTWTWTWTTTTTEW
WVWWWTWTWTWTWTWWWWEW
WETTTTWTWTWTWTTTTTEW
WEWWWTWTWTWTWTWWWWEW
WETTTTWTWTWTWTTTTTEW
WEEEEEEEEEEEEEEEEEEW
WWWWWWWWWGWWWWWWWWWW
