W W W W W W W W W W W W W W W W W W W W
W E E E E T E E E E E E E T E E E E E W
W E W W W T W T W T W T W T W W W W E W
W E T T T T W T W T W T W T T T T T E W
W E W W W T W T W T W T W T W W W W E W
W E T T T T W T W T W T W T T T T T E W
W V W W W T W T W T W T W T W W W W E W
W E T T T T W T W T W T W T T T T T E W
W E W W W T W T W T W T W T W W W W E W
W E T T T T W T W T W T W T T T T T E W
W E E E E E E E E E E E E E E E E E E W
W W W W W W W W W G W W W W W W W W W W
