W W W W W W W W W W W W W W W W W W W W
W E E E E E W W W W W W W W E E E E E W
W E T W T E W T T T T T T W E T W T E W
W E T W T E W T W T T W T W E T W T E W
W E T W T E W T T W W T T W E T W T E W
W V W W W E T T T T T T T T E W W W E G
W E T W T E W T T W W T T W E T W T E W
W E T W T E W T W T T W T W E T W T E W
W E T W T E W T T T T T T W E T W T E W
W E E E E E W W W W W W W W E E E E E W
W E E E E E E E E W W E E E E E E E E W
W W W W W W W W W W W W W W W W W W W W
