WWWWWWWWWWWWWWWWWWWW
WEEEEEWWWWWWWWEEEEEW
WETWTEWTTTTTTWETWTEW
WETWTEWTWTTWTWETWTEW
WETWTEWTTWWTTWETWTEW
WVWWWETTTTTTTTEWWWEG
WETWTEWTTWWTTWETWTEW
WETWTEWTWTTWTWETWTEW
WETWTEWTTTTTTWETWTEW
WEEEEEWWWWWWWWEEEEEW
WEEEEEEEEWWEEEEEEEEW
WWWWWWWWWWWWWWWWWWWW
