WWWWWWWWWWWWWWWWWWWW
WEEEEEEEEVEEEEEEEEEW
WEWTWWTTWTTWTTWWTWEW
WEWTEWWTWTTWTWWETWEW
WEWTTEWTTWWTTWETTWEW
WEEWTTETTWWTTETTWEEW
WEEEWTTEWTTWETTWEEEW
WEEEEWTTWTTWTTWEEEEW
WETEEEWTTTTTTWEEETEW
WEETEEEWWWWWWEEETEEW
WEEEEEEEEGWEEEEEEEEW
WWWWWWWWWWWWWWWWWWWW
