W W W W W W W W W W W W W W W W W W W W
W E E E E E E E E V E E E E E E E E E W
W E W T W W T T W T T W T T W W T W E W
W E W T E W W T W T T W T W W E T W E W
W E W T T E W T T W W T T W E T T W E W
W E E W T T E T T W W T T E T T W E E W
W E E E W T T E W T T W E T T W E E E W
W E E E E W T T W T T W T T W E E E E W
W E T E E E W T T T T T T W E E E T E W
W E E T E E E W W W W W W E E E T E E W
W E E E E E E E E G W E E E E E E E E W
W W W W W W W W W W W W W W W W W W W W
