WWWWWWWWWWWWWWWWWWWW
WTTTTTTTTTTTTTTTTTTW
WTTTTWWWWTTWWWWTTTTW
WTTTTWTTTTTWEEWTTTTW
GTTTTWTTTTTWEEWTTTTW
WVTTTWWWWTTWEEWTTTTW
WTTTTTTTWTTWEEWTTTTW
WTTTTTTTWTTWEEWTTTTW
WTTTTWTTWTTWEEWTTTTW
WTTTTWWWWTTWWWWTTTTW
WTTTTTTTTTTTTTTTTTTW
WWWWWWWWWWWWWWWWWWWW
