W W W W W W W W W W W W W W W W W W W W
W T T T T T T T T T T T T T T T T T T W
W T T T T W W W W T T W W W W T T T T W
W T T T T W T T T T T W E E W T T T T W
G T T T T W T T T T T W E E W T T T T W
W V T T T W W W W T T W E E W T T T T W
W T T T T T T T W T T W E E W T T T T W
W T T T T T T T W T T W E E W T T T T W
W T T T T W T T W T T W E E W T T T T W
W T T T T W W W W T T W W W W T T T T W
W T T T T T T T T T T T T T T T T T T W
W W W W W W W W W W W W W W W W W W W W
