WWWWWWWWWWWWWWWWWWWWWWWWWWWW
WVEEEEEEEEEEEEEEEEEEEEEEEEEW
WEEEEEEEEEEEEEEEEEEEEEEEEEEW
WEEEEEEEEEEEEEEEEEEEEEEEEEEW
WEEEEEEEEEETEEEEEEEEEEEEEEEW
WEEEEEEEEEEEEEEEEEEEEEEEEEEW
WEEEEEEEEEEEEEEEEEEEEEEEEEEW
WEEEEEEEEEEEEEEEEEEEEEEEEEEW
WEEEEEEEEEEEEEEEEEEEEEEEEEGW
WWWWWWWWWWWWWWWWWWWWWWWWWWWW