WWWWWWWWWWWW
WVTWTETWTETW
WWEWEWEWEWEW
WTTWEWEWEWEW
WEWWEWEWEWEW
WTEETWTETWGW
WWWWWWWWWWWW
